April	French
Renee	Boyd
Micheal	Jordan
Antonia	Elliott
Lyle	Rhodes
Saul	Morrison
Joey	Neal
Alexander Green
Damon	Peterson
Marvin	Perkins
Ashley	Howard
Melody	King
Mike	Matthews
Fredrick Washington
Conrad	Fuller
Kelli	Martinez
Theresa	Bradley
Tammy	Guerrero
Debbie	Pittman
Leroy	Blair
Paula	Mccormick
Marie	Schneider
Spencer	Andrews
Lucia	Weaver
Leland	Hale
Andres	Barnes
Stacy	Lowe
Yvette	Garrett
Willard	Edwards
Susan	Lynch
Lisa	Gibson
Brett	Morgan
Matt	Collins
Naomi	Long
Russell	Wallace
Eunice	Blake
Ernestine	Luna
Jaime	Pope
Robin	Hogan
Silvia	Castillo
Kim	Bates
Blake	Mack
Lawrence Bryan
Marco	Mann
Hubert	Mendez
Jan	Reed
Rachael	Stevenson
Carole	Francis
Randy	Ortiz
Byron	Fernandez
John 	Richards
Donald 	Duck
